111111
1P0C11
1000C1
1C0E11
111111